7
3 0 5 0 1 0 1 1
1 0 0 1 0 1 0 1
0 5 1 0 0 0 0 1
0 1 0 0 5 0 1 0
0 1 0 1 0 1 1 1
1 0 0 1 0 5 0 1
1 0 1 0 0 1 0 1
1 1 1 1 1 1 0 2

3-g	4-r	5-k	6-b	7-q