5
6 1 1 0 1 1 1 3
1 1 1 1 1 1 1 1
1 1 1 1 1 1 1 1
0 1 1 0 0 1 1 1
1 0 1 0 0 1 1 0
1 1 1 1 1 1 1 1
1 1 1 0 1 1 1 1
2 1 1 1 0 1 1 6

3-g	4-r	5-k	6-b	7-q