6
1 1 1 1 1 1 0 4
1 1 1 1 1 1 1 1
1 1 1 4 1 3 0 1
1 5 1 1 0 1 0 1
1 1 1 6 1 0 0 1
1 1 1 1 1 0 1 1
1 2 1 0 1 0 1 0
1 1 1 0 1 1 1 0